Time, File, Conversion, Render, Resize, Total, Status
3/13/2019 6:15:54 PM, 100SlidePowerPointPres.ppt, 2838, 2, 18, 2858, Ok
3/13/2019 6:15:55 PM, 131814.xls, 814, 2, 11, 827, Ok
3/13/2019 6:15:55 PM, 1excel 2003.xls, 105, 5, 11, 121, Ok
3/13/2019 6:15:55 PM, 1PPT 2003.ppt, 251, 2, 6, 259, Ok
3/13/2019 6:15:56 PM, 1PPTX 2003.pot, 296, 2, 6, 304, Ok
3/13/2019 6:15:56 PM, 1Read only excel 2003.xls, 22, 3, 11, 36, Ok
3/13/2019 6:15:57 PM, 1Read Only Word 2003.doc, 1339, 2, 11, 1352, Ok
3/13/2019 6:15:57 PM, 1Template excel 2003.xlt, 22, 2, 11, 35, Ok
3/13/2019 6:15:57 PM, 1Word 2003 template.dot, 127, 2, 10, 139, Ok
3/13/2019 6:15:57 PM, 1Word 2003.doc, 75, 2, 10, 87, Ok
3/13/2019 6:15:58 PM, 2003PowerPointPres.PPT, 203, 5, 6, 214, Ok
3/13/2019 6:15:58 PM, 2016 32bit file_colors.docx, 193, 2, 10, 205, Ok
3/13/2019 6:15:58 PM, 2016 32bit file_colors_111.odt, 281, 2, 10, 293, Ok
3/13/2019 6:15:58 PM, 2018.05.25.00.03.04(1).xlsx, 204, 2, 11, 217, Ok
3/13/2019 6:15:58 PM, 2018.05.25.00.03.04.xlsx, 38, 2, 11, 51, Ok
3/13/2019 6:15:59 PM, 29 pages.docx, 115, 1, 10, 126, Ok
3/13/2019 6:15:59 PM, 3 - PrepareForMigration.ppsx, 540, 2, 7, 549, Ok
3/13/2019 6:16:00 PM, 3_original.xls, 438, 1, 10, 449, Ok
3/13/2019 6:16:00 PM, 479 Pages.doc, 209, 2, 10, 221, Ok
3/13/2019 6:16:00 PM, 4_original.xlsx, 18, 2, 11, 31, Ok
3/13/2019 6:16:00 PM, 5_original_2007template.xltx, 247, 2, 10, 259, Ok
3/13/2019 6:16:00 PM, 719 Pages.doc, 244, 1, 10, 255, Ok
3/13/2019 6:16:01 PM, all keyboard chars.DOC, 58, 22, 12, 92, Ok
3/13/2019 6:16:02 PM, Big document.doc, 1379, 2, 10, 1391, Ok
3/13/2019 6:16:02 PM, Binary2016.xlsx, 35, 2, 12, 49, Ok
3/13/2019 6:16:05 PM, Buddy Requirement.DOC, 2561, 2, 10, 2573, Ok
3/13/2019 6:16:05 PM, Calorie amortization schedule1.xlsx, 377, 2, 11, 390, Ok
3/13/2019 6:16:05 PM, ClaimsAdmin.pptx, 391, 2, 7, 400, Ok
3/13/2019 6:16:06 PM, ClaimsAdmin2016.pptx, 279, 2, 6, 287, Ok
3/13/2019 6:16:06 PM, ColoredFonts.xlsx, 13, 2, 11, 26, Ok
3/13/2019 6:16:06 PM, ColoredFonts.zip, 3, 0, 0, 3, Error
3/13/2019 6:16:06 PM, created by pam - readonly - final.docx, 60, 2, 10, 72, Ok
3/13/2019 6:16:06 PM, DOC 2013.doc, 76, 2, 10, 88, Ok
3/13/2019 6:16:06 PM, DOCM 2013.docm, 138, 11, 10, 159, Ok
3/13/2019 6:16:07 PM, Document less 5mb-2013.dotm, 492, 3, 10, 505, Ok
3/13/2019 6:16:07 PM, Document Preview-2013.xlsx, 21, 2, 11, 34, Ok
3/13/2019 6:16:07 PM, DOCX 2013.docx, 211, 2, 10, 223, Ok
3/13/2019 6:16:07 PM, DOT 2013.dot, 141, 1, 10, 152, Ok
3/13/2019 6:16:07 PM, DOTM 2013.dotm, 224, 2, 10, 236, Ok
3/13/2019 6:16:07 PM, DOTX 2013.dotx, 99, 2, 10, 111, Ok
3/13/2019 6:16:07 PM, EmptyDoc 2003.doc, 21, 2, 11, 34, Ok
3/13/2019 6:16:07 PM, Emptyexcel2003.xls, 12, 2, 11, 25, Ok
3/13/2019 6:16:07 PM, emptyexceltemplate2003.xlt, 11, 2, 11, 24, Ok
3/13/2019 6:16:08 PM, emptyppt.ppt, 54, 2, 6, 62, Ok
3/13/2019 6:16:13 PM, Entire_Gutenberg_Twain_Texts.rtf, 5166, 2, 11, 5179, Ok
3/13/2019 6:16:13 PM, excel 2003.xls, 30, 2, 11, 43, Ok
3/13/2019 6:16:13 PM, Excel 2007 read only.xlsx, 62, 2, 11, 75, Ok
3/13/2019 6:16:13 PM, Excel 2007 template.xltm, 56, 2, 11, 69, Ok
3/13/2019 6:16:13 PM, Excel 2007 template.xltx, 61, 2, 10, 73, Ok
3/13/2019 6:16:13 PM, Excel 2007.xlsb, 89, 2, 11, 102, Ok
3/13/2019 6:16:13 PM, Excel 2007.xlsm, 60, 2, 11, 73, Ok
3/13/2019 6:16:13 PM, Excel 2007.xlsx, 58, 2, 11, 71, Ok
3/13/2019 6:16:13 PM, excel 2010.xlsb, 38, 2, 11, 51, Ok
3/13/2019 6:16:13 PM, excel 2010.xlsm, 37, 2, 11, 50, Ok
3/13/2019 6:16:13 PM, excel 2010.xlsx, 35, 2, 10, 47, Ok
3/13/2019 6:16:13 PM, excel 2016.xlsx, 35, 2, 11, 48, Ok
3/13/2019 6:16:14 PM, excel 2016_1page.xls, 30, 2, 10, 42, Ok
3/13/2019 6:16:14 PM, excel1 2003.XLS, 21, 2, 11, 34, Ok
3/13/2019 6:16:14 PM, Excel1 2007 template.XLTM, 59, 2, 11, 72, Ok
3/13/2019 6:16:14 PM, Excel1 2007.XLSM, 64, 2, 13, 79, Ok
3/13/2019 6:16:14 PM, excel1 2010.XLSB, 36, 3, 19, 58, Ok
3/13/2019 6:16:14 PM, excel2013_empty.xlsx, 13, 3, 11, 27, Ok
3/13/2019 6:16:14 PM, Excel_5worksheets_500rows.xls, 72, 2, 11, 85, Ok
3/13/2019 6:16:14 PM, Excel_5worksheets_500rows.xlsx, 68, 2, 19, 89, Ok
3/13/2019 6:16:14 PM, given_simple_pp_macro_template.POTM, 85, 2, 7, 94, Ok
3/13/2019 6:16:14 PM, given_simple_pp_template.POTX, 46, 2, 7, 55, Ok
3/13/2019 6:16:14 PM, ImageRight MINT POC Issues-2013.xlt, 64, 2, 10, 76, Ok
3/13/2019 6:16:14 PM, ImageRightFaxCover.dot, 165, 1, 10, 176, Ok
3/13/2019 6:16:15 PM, IR Viewer Retail-2013.potx, 157, 2, 12, 171, Ok
3/13/2019 6:16:15 PM, IR Viewer Retail-2013.ppsx, 118, 2, 6, 126, Ok
3/13/2019 6:16:15 PM, IR Viewer Retail-2013.pptm, 255, 2, 6, 263, Ok
3/13/2019 6:16:15 PM, IR Viewer Retail-2013.pptx, 120, 2, 6, 128, Ok
3/13/2019 6:16:15 PM, Large.xlsx, 189, 2, 11, 202, Ok
3/13/2019 6:16:16 PM, LargeBook1.xlsx, 186, 4, 10, 200, Ok
3/13/2019 6:16:16 PM, Macro 2016.xlsm, 35, 5, 10, 50, Ok
3/13/2019 6:16:16 PM, macro2016.pptm, 221, 2, 7, 230, Ok
3/13/2019 6:16:16 PM, Macroword 2016.docm, 341, 2, 12, 355, Ok
3/13/2019 6:16:16 PM, Mad kitty.docx, 83, 2, 10, 95, Ok
3/13/2019 6:16:16 PM, OCR FAQ - 2013.dotx, 88, 2, 11, 101, Ok
3/13/2019 6:16:17 PM, OCR Workflow Scripting-2013.docm, 66, 2, 11, 79, Ok
3/13/2019 6:16:17 PM, POT 2013.pot, 168, 2, 6, 176, Ok
3/13/2019 6:16:17 PM, POTM 2013.potm, 43, 2, 6, 51, Ok
3/13/2019 6:16:17 PM, POTX 2013.potx, 66, 2, 7, 75, Ok
3/13/2019 6:16:17 PM, powerpoint file in ppSm (show .PPSM, 174, 2, 7, 183, Ok
3/13/2019 6:16:17 PM, powerpoint file in ppSm (show macro)format.ppsm, 153, 2, 6, 161, Ok
3/13/2019 6:16:18 PM, powerpoint file in ppSx (show )format.ppsx, 183, 2, 7, 192, Ok
3/13/2019 6:16:18 PM, powerpoint file in ppSx (show .PPSX, 153, 2, 6, 161, Ok
3/13/2019 6:16:18 PM, powerpoint file in pptm (macro)format.pptm, 158, 2, 6, 166, Ok
3/13/2019 6:16:18 PM, powerpoint file in pptm (macro.PPTM, 161, 2, 7, 170, Ok
3/13/2019 6:16:18 PM, powerpoint file in pptx format.pptx, 164, 2, 6, 172, Ok
3/13/2019 6:16:19 PM, PPS.pps, 307, 2, 6, 315, Ok
3/13/2019 6:16:19 PM, PPSM 2013.ppsm, 391, 2, 7, 400, Ok
3/13/2019 6:16:19 PM, PPSX 2013.ppsx, 103, 2, 6, 111, Ok
3/13/2019 6:16:19 PM, PPT 2003 read-only.ppt, 228, 2, 6, 236, Ok
3/13/2019 6:16:20 PM, PPT 2003.ppt, 170, 2, 6, 178, Ok
3/13/2019 6:16:20 PM, PPT 2013.ppt, 186, 2, 7, 195, Ok
3/13/2019 6:16:20 PM, PPT2013_empty.pptx, 40, 2, 7, 49, Ok
3/13/2019 6:16:20 PM, PPTM.pptm, 45, 2, 7, 54, Ok
3/13/2019 6:16:20 PM, PPTX 2003.POT, 206, 3, 9, 218, Ok
3/13/2019 6:16:20 PM, PPTX 2007.pptm, 165, 2, 7, 174, Ok
3/13/2019 6:16:21 PM, PPTX 2007.pptx, 146, 2, 6, 154, Ok
3/13/2019 6:16:21 PM, pptx 2010 - read-only-final.pptx, 148, 2, 6, 156, Ok
3/13/2019 6:16:21 PM, pptx 2010.pptm, 126, 2, 7, 135, Ok
3/13/2019 6:16:21 PM, pptx 2010.pptx, 183, 2, 7, 192, Ok
3/13/2019 6:16:21 PM, PPTX 2013.pptx, 173, 2, 7, 182, Ok
3/13/2019 6:16:22 PM, Print Screen.doc, 108, 2, 11, 121, Ok
3/13/2019 6:16:22 PM, Read only excel 2003.xls, 24, 2, 11, 37, Ok
3/13/2019 6:16:22 PM, read only excel 2010.xlsx, 39, 2, 11, 52, Ok
3/13/2019 6:16:22 PM, read only excel 2016.xlsx, 36, 2, 13, 51, Ok
3/13/2019 6:16:22 PM, Read only excel1 2003.XLS, 22, 3, 11, 36, Ok
3/13/2019 6:16:22 PM, Read Only Word 2003.doc, 67, 2, 10, 79, Ok
3/13/2019 6:16:22 PM, read only word 2010.docx, 205, 2, 11, 218, Ok
3/13/2019 6:16:22 PM, read only word 2016.docx, 197, 1, 10, 208, Ok
3/13/2019 6:16:22 PM, Read-only-2013.xlsx, 66, 2, 11, 79, Ok
3/13/2019 6:16:23 PM, read-only-YN-2013.docm, 146, 2, 11, 159, Ok
3/13/2019 6:16:23 PM, read-only2016.pptx, 173, 2, 7, 182, Ok
3/13/2019 6:16:23 PM, readonly.docx, 65, 3, 11, 79, Ok
3/13/2019 6:16:23 PM, RTF 2013.rtf, 363, 2, 10, 375, Ok
3/13/2019 6:16:23 PM, Scenarios-2013.xlsm, 42, 2, 10, 54, Ok
3/13/2019 6:16:24 PM, SimpleExcelWorksheet.xlsx, 305, 2, 10, 317, Ok
3/13/2019 6:16:24 PM, Template excel 2003.xlt, 21, 2, 11, 34, Ok
3/13/2019 6:16:24 PM, Template excel1 2003.XLT, 24, 2, 11, 37, Ok
3/13/2019 6:16:24 PM, Test FIle.xltx, 11, 2, 11, 24, Ok
3/13/2019 6:16:24 PM, TEST-MULTIPAGE.docx, 69, 2, 10, 81, Ok
3/13/2019 6:16:24 PM, TEST.docx, 60, 3, 10, 73, Ok
3/13/2019 6:16:24 PM, test.xlsx, 12, 2, 10, 24, Ok
3/13/2019 6:16:24 PM, Test1.ppt, 190, 2, 7, 199, Ok
3/13/2019 6:16:24 PM, Test1.xls, 15, 3, 10, 28, Ok
3/13/2019 6:16:24 PM, Test1_2013.pptm, 188, 2, 7, 197, Ok
3/13/2019 6:16:25 PM, Test2.PPT, 216, 2, 6, 224, Ok
3/13/2019 6:16:25 PM, Test2.xls, 10, 2, 12, 24, Ok
3/13/2019 6:16:25 PM, Test3Large.XLS, 65, 2, 11, 78, Ok
3/13/2019 6:16:25 PM, This is a docm file.docm, 78, 2, 11, 91, Ok
3/13/2019 6:16:25 PM, This is a great spot for a mission statement-2013.docx, 164, 2, 10, 176, Ok
3/13/2019 6:16:25 PM, Trouble adding Burn Queues.docx, 85, 1, 10, 96, Ok
3/13/2019 6:16:29 PM, twainmaretext02mtent13rtf.rtf, 3498, 2, 11, 3511, Ok
3/13/2019 6:16:29 PM, Waterton Final WS.xls, 106, 3, 12, 121, Ok
3/13/2019 6:16:29 PM, Wedding budget1-2013.xlsb, 131, 1, 11, 143, Ok
3/13/2019 6:16:29 PM, Werbung_1.PPS, 195, 2, 6, 203, Ok
3/13/2019 6:16:29 PM, Word 2003 read-only-final.DOC, 65, 1, 10, 76, Ok
3/13/2019 6:16:29 PM, Word 2003 template.DOT, 69, 1, 10, 80, Ok
3/13/2019 6:16:29 PM, Word 2003.doc, 66, 2, 10, 78, Ok
3/13/2019 6:16:30 PM, Word 2003.one page.doc, 65, 2, 11, 78, Ok
3/13/2019 6:16:30 PM, Word 2007 read only.docx, 79, 2, 11, 92, Ok
3/13/2019 6:16:30 PM, Word 2007 template.DOTM, 378, 2, 10, 390, Ok
3/13/2019 6:16:30 PM, Word 2007 template.dotx, 321, 2, 9, 332, Ok
3/13/2019 6:16:30 PM, Word 2007.docx, 63, 2, 11, 76, Ok
3/13/2019 6:16:31 PM, Word 2010 Template.DOTX, 57, 2, 10, 69, Ok
3/13/2019 6:16:31 PM, word 2010.docm, 209, 2, 11, 222, Ok
3/13/2019 6:16:31 PM, word 2010.docx, 203, 1, 11, 215, Ok
3/13/2019 6:16:31 PM, Word_250 pages.docx, 260, 2, 11, 273, Ok
3/13/2019 6:16:32 PM, Word_500 pages.doc, 243, 1, 11, 255, Ok
3/13/2019 6:16:32 PM, Word_500 pages.docx, 480, 2, 11, 493, Ok
3/13/2019 6:16:32 PM, XLS 2013.xls, 158, 1, 10, 169, Ok
3/13/2019 6:16:32 PM, XLSB 2013.xlsb, 122, 2, 10, 134, Ok
3/13/2019 6:16:32 PM, xlsB formated workbook.xlsb, 21, 1, 10, 32, Ok
3/13/2019 6:16:33 PM, XLSM 2013.xlsm, 153, 2, 9, 164, Ok
3/13/2019 6:16:33 PM, xlsM formated workbook.xlsm, 17, 2, 11, 30, Ok
3/13/2019 6:16:33 PM, XLT 2013.xlt, 76, 2, 10, 88, Ok
3/13/2019 6:16:33 PM, XLTM 2013.xltm, 69, 2, 11, 82, Ok
3/13/2019 6:16:33 PM, XLTX 2013.xltx, 132, 2, 10, 144, Ok
3/13/2019 6:16:33 PM, XSLX 2016.xlsx, 97, 2, 11, 110, Ok
